Month,Payment,Interest,Principal,Remaining Balance
1,50.0,0.0,50.0,1150.0
2,50.0,0.0,50.0,1100.0
3,50.0,0.0,50.0,1050.0
4,50.0,0.0,50.0,1000.0
5,50.0,0.0,50.0,950.0
6,50.0,0.0,50.0,900.0
7,50.0,0.0,50.0,850.0
8,50.0,0.0,50.0,800.0
9,50.0,0.0,50.0,750.0
10,50.0,0.0,50.0,700.0
11,50.0,0.0,50.0,650.0
12,50.0,0.0,50.0,600.0
TOTAL,600.0,0.0,600.0,
