Month,Payment,Interest,Principal,Remaining Balance
1,200.0,0.0,200.0,1000.0
2,200.0,0.0,200.0,800.0
3,200.0,0.0,200.0,600.0
4,200.0,0.0,200.0,400.0
5,200.0,0.0,200.0,200.0
6,200.0,0.0,200.0,0.0
TOTAL,1200.0,0.0,1200.0,
